{
    "xdimensions": [
        25,
        1,
        25
    ],
    "levelseed": -11,
    "type": "smallHills",
    "agentStart": [
        0,
        0,
        0
    ],
    "agentGoal": [
        24,
        0,
        24
    ],
    "exportlevel": [
        12, 12, 12, 12, 12, 12, 12, 12, 12, 12, 12, 12, 12, 12, 12, 12, 12, 12, 12, 12, 12, 12, 12, 12, 12,
        12, 12, 12, 12, 12, 12, 12, 12, 12, 12, 12, 12, 12, 12, 12, 12, 12, 12, 12, 12, 12, 12, 12, 12, 12,
        12, 12, 12, 11, 12, 12, 12, 11, 11, 11, 11, 12, 12, 12, 12, 12, 12, 12, 12, 12, 12, 12, 12, 12, 12,
        12, 12, 12, 11, 12, 12, 12, 11, 11, 11, 11, 12, 12, 12, 12, 12, 12, 12, 11, 11, 11, 12, 12, 12, 12,
        12, 12, 12, 11, 12, 12, 12, 11, 11, 11, 11, 12, 12, 11, 11, 12, 12, 12, 11, 11, 11, 12, 12, 12, 12,
        12, 12, 12, 12, 12, 12, 12, 11, 11, 11, 11, 12, 12, 12, 12, 12, 12, 12, 12, 12, 12, 12, 11, 12, 12,
        12, 12, 12, 12, 12, 12, 12, 12, 12, 12, 12, 12, 12, 12, 12, 12, 12, 12, 12, 12, 12, 12, 11, 12, 12,
        12, 12, 12, 11, 11, 11, 12, 12, 12, 12, 12, 12, 12, 12, 12, 12, 12, 12, 12, 12, 12, 12, 11, 12, 12,
        12, 12, 12, 11, 11, 11, 12, 12, 12, 12, 11, 11, 11, 12, 12, 12, 11, 11, 11, 12, 12, 12, 12, 12, 12,
        12, 12, 12, 11, 11, 11, 12, 12, 12, 12, 11, 11, 11, 12, 12, 12, 11, 11, 11, 12, 12, 12, 12, 12, 12,
        12, 12, 12, 12, 12, 12, 12, 12, 12, 12, 11, 11, 11, 12, 12, 12, 12, 12, 12, 12, 12, 12, 11, 12, 12,
        12, 12, 12, 12, 12, 12, 12, 12, 12, 12, 12, 12, 12, 12, 12, 12, 12, 12, 12, 12, 12, 12, 11, 12, 12,
        12, 12, 11, 11, 11, 12, 12, 12, 12, 12, 12, 12, 12, 11, 12, 12, 12, 12, 12, 12, 12, 12, 12, 12, 12,
        12, 12, 11, 11, 11, 12, 12, 12, 12, 11, 11, 12, 12, 12, 12, 12, 12, 12, 11, 11, 11, 12, 12, 12, 12,
        12, 12, 12, 12, 12, 12, 12, 12, 12, 12, 12, 12, 12, 12, 12, 12, 12, 12, 11, 11, 11, 12, 12, 12, 12,
        12, 12, 12, 12, 12, 12, 12, 12, 12, 12, 12, 12, 11, 11, 12, 12, 12, 12, 11, 11, 11, 12, 12, 12, 12,
        12, 12, 12, 12, 11, 11, 11, 11, 12, 12, 12, 12, 11, 11, 12, 12, 12, 12, 12, 12, 12, 12, 12, 12, 12,
        12, 12, 12, 12, 11, 11, 11, 11, 12, 12, 12, 12, 11, 11, 12, 12, 12, 12, 12, 12, 12, 12, 11, 11, 12,
        12, 12, 12, 12, 11, 11, 11, 11, 12, 12, 12, 12, 12, 12, 12, 12, 12, 12, 12, 12, 12, 12, 12, 12, 12,
        12, 12, 12, 12, 11, 11, 11, 11, 12, 12, 12, 12, 12, 12, 12, 12, 12, 11, 11, 11, 11, 12, 12, 12, 12,
        12, 12, 12, 12, 12, 12, 12, 12, 12, 12, 12, 12, 12, 12, 12, 12, 12, 11, 11, 11, 11, 12, 12, 12, 12,
        12, 12, 12, 12, 12, 12, 12, 12, 12, 12, 12, 12, 11, 12, 12, 12, 12, 11, 11, 11, 11, 12, 12, 12, 12,
        12, 12, 11, 11, 12, 12, 12, 12, 12, 12, 12, 12, 11, 12, 12, 12, 12, 12, 12, 12, 12, 12, 12, 11, 12,
        12, 12, 11, 11, 12, 12, 12, 12, 12, 11, 12, 12, 12, 12, 12, 12, 12, 12, 12, 12, 12, 12, 12, 12, 12,
        12, 12, 12, 12, 12, 12, 12, 12, 12, 12, 12, 12, 12, 12, 12, 12, 12, 12, 12, 12, 12, 12, 12, 12, 12
    ],
    "resultPath": []
}